111111111111111
1E01000X00000C1
100000000000001
110000000000001
100000000X0C001
1P0000000000001
10000000C0000X1
111111111111111