111111111111
1000C0000001
10000000E001
1P0000000001
100C00000001
111111111111