111111111111
1000C0000001
10P00000E001
100000000001
100C00000001
111111111111