111111111111
1C00000000E1
100000000001
100000000001
1P00000000C1
111111111111