111111111111
1000C0C0C0C1
10P00000E001
1C0000000011
100C00C001C1
111111111111