111111111111
1000C0000001
10P00000E001
100000000011
100C00000101
111111111111