111111111111
1000C0C0C0C1
10P00000E001
100000000011
100C00000101
111111111111