111111111111111
1E01000000000C1
100000000000001
110000000000001
10000000000C001
100000000000001
10000000C000001
111111111111111
